DWWWWWWWWWWWWWWWWWWW
EEEEEEEEEEEEEEEEEEEW
WWWEWWWWWWWWWWWWWWEW
EEEEEEEEWWEEEEEEEEEW
EEEEEEEWEEEWEEEWWWWW
EWWWWEEWEEWEWEWEEEEW
EEWEWEEWEWEEEWEEEEEW
EEWEWEEWEWEEEEEEEWEW
WWWEWEEWEEWEEEEEEWEW
EEWEEWEEWEEEEEWEWEEW
EEWEEEWEEWEWEWWWEWEW
WEEEEEEWEEEWWEEEEEEW
WEEWEEEEWWWEEEEWEWEW
WEEWEEEEEEEEEEEEWEEW
WEEWWWWEEEEWWEEWEEEW
WEEEWEWEEEEEWWWWWWEW
WEEEEWWEWWEEEEEEEWEW
WEEEEEEWEEWEEEEEWEEW
WEEEEEEEEEEEEEEEEEEW
WWWWWWWWWWWWWWWWWWEA